111111111111111111111111111111111
100000000000000000000000000000001
10e000000000000000000000000000f01
100000000000000000000000000000001
100000111111100000001111111000001
100000000000000000000000000000001
100010000000000000000000000010001
100010000000000000000000000010001
100010001110001111100011100010001
100010001110000000000011100010001
100010001110000000000011100010001
100010000000000000000000000010001
100010000000001111100000000010001
100000000000000000000000000000001
100000000100001101100001000000001
100000000100001101100001000000001
100000000100000000000001000000001
100000000100001101100001000000001
100000000100001101100001000000001
100000000000000000000000000000001
100010000000001111100000000010001
100010000000000000000000000010001
100010000000000000000000000010001
100010001110000000000011100010001
100010001110001111100011100010001
100010001110000000000011100010001
100010000000000000000000000010001
100000000000000000000000000000001
100000111111100000001111111000001
100000000000000000000000000000001
10g000000000000000000000000000h01
100000000000000000000000000000001
111111111111111111111111111111111