111111111   111111111111111111111111111111111111111111111111111111111111111   111111111111111111111111111111111111111111
100000001   100000000000000000000000000000000000000000000000000000000000001   100000000b00000000000000000000000000000001
100000001   100000000000000000000000000000000000000000000000000000000000001   100000000b00000000000000000000000000000001
100000001   100000000000000000000000000000000000000000000000000000000000001   100000000b00000000000000000000000000000001
100000001   100000000000000000000000000000000000000000000000000000000000001   100000000b00000000000000000000000000000001
10000b001   100000000000000111110000000000000000000000000000000000000000001   111111111111111111110000000000000000000001
100000001   1000000000000001   10000000000000000000000000000000000000000001                      10000000000000000000001
100000001   1000000000000001   10000000000000000000000000000000000000000001                      10000000000000000000001
100000001   1000000000000001   10000000000000000000000000000000000000000001                      1bbb000000000000000bbb1
1b0000001   1000000000000001   1000000000000bbbbbbbbbbbbbbbbbb0000000000001                      10000000000000000000001
100000001   1000000000000001   10000000000000000000000000000000000000000001111111111111111111111110000000000000000000001
100000001   1000000000000001   10000000000000000000000000000000000000000000000000000b00000000000000000000000000000000001
100000001   1000000000000001   10000000000000000000000000000000000000000000000000000b00000000000000000000000000000000001
100000001   1000000000000001   10000000000000000000000000000000000000000000000000000000000000000000000000000000000000001
1000000011111000000000000001   10000000000000000000000000000000000000000000000000000000000000000000000000000000000000001
1000000000b00000000000000001   10000000000000000000000000000000000000000000000000000000000000000000000000000000000000001
1000000000000000000000000001   10000000000000000000000000000000000000000000000000000000000000000000000000000000000000001
1000000000000000000000000001   10000000000000000000000000000000000000000000000000000b00000000000000000000000000000000001
1000000000b00000000000000001   10000000000000000000000000000000000000000000000000000b00000000000000000000000000000000001
1111111111111111111111111111   11111111111111111111111111111111111111111111111111111111111111111111111111111111111111111